O S O B B
O O O B B
B B O B B
O O O O B
B B O O E
