S O O O O B B B B B B B
O O B B O B B B B B B O 
O O O O O O B O O O B O
O O B B B O O O B O O O
O O B B O O O O O O O O
B O O O O O O B B B O B
B O O O O O O O O O O B
B O O B B O O B B B E B
B O O O O O O B B B O B
B B B B B B O B B B O B
B B B B B B O O O O O B
B B B B B B B B B B B B
