S O O O O O O O O O B B B B B O O O O O B B B B B B B O O O O
O O O O O O O O O O B B B B B O O O O O O O O O O O O O O O O
O O B B B B O O O O O O O O O O O O O O O O O O O O O O O B B
O O B B B B O O O O O O O O O O O O O O B B O O B B B O O B B
O O O O O O O O O O B B B B B O O O O O B B O O B B B O O O O
B B B O O O B B O O O O B B B O O O O O B B O O B B B O O O O
B B B O O O B B O O B O O B B O O O O O B B O O B B B O O O O
B B B O O O B B O O B B O O B O O O O O B B O O B B B O O O O
B B B O O O B B O O B B 0 O O O B B O O O O O O O O O O O O O
O O O O O O O O O O O O O O O O B B O O O O O O O O O O O O O
O O O O B B O O O B B O O B B O O O O O O O O O B B B O O O O
O O O O B B O O O B B O O B B O B B O O O O O O B B B O O O O
O O O O O O O B O O O O O O O O B B O O O O O O O O O O O O O
O O O O O O O B O O O O O O O O O O B B O O O O O O O O O O O
B B B B O O O B O O O O B B B O O O B B O O O O O O O O O O O
B B B B O O O O O O O O B B B O O O O O O O O O O O O O B B O
B B O O O O O O O O O O B B B O O O B B O O O O O O O O B B O
B B O O B B O B B B B O O O O O B B B B O O O O O O O O B B O
B B O O B B O B O O B O O O O O B B O O O O B B B B O O B B O
B B O O B B O B O O B O O O O O B B O O O O B B B B O O B B O
B B O O O O O B O O B O O O O O B B O O O O O O O O O O B B O
B B O O B B O O O O B O O O O O B B O O O O O O O O O O O O O
B B O O B B O O O B B O O O O O B B O O O O B B B B O O O O O
B B O O B B O O O B B O O O O O O O O O O O B B O O O O O O O
O O O O B B O O O B B O O B B O O O O O O O B B O B O O O O O
O O O O B B O O O O O O O B B O B B O O O O O O O O O O O O O
O O O O O O O O O O O O O B B O B B O O O B B O O O O O B B B
O O O O O O B B B O O O O O O O B B O O O B B O O O O O B B B
O O O O O O B B B O O B B O O O O O O O O O O O O O O O B B B
O O O O O O O O O O O B B O O O O O O O O B B O O O O O O O E
O O O O O O O O O O O B B O O O O O O O O B B O O O O O O O O